Canada	NorthAmerican
Turkey	MiddleEastern
east_asian	EastAsian
Caribbean	LatinAmerican
Bangladesh	SouthAsian
chinese	EastAsian
mexico	LatinAmerican
Lebanon	MiddleEastern
japanese	EastAsian
North-African	African
MiddleEastern	MiddleEastern
Indian	SouthAsian
asian	
Italy	SouthernEuropean
EasternEuropean_Russian	EasternEuropean
Israel	MiddleEastern
Korea	EastAsian
Iran	MiddleEastern
Eastern-Europe	EasternEuropean
Jewish	MiddleEastern
South-African	African
Vietnamese	SoutheastAsian
UK-and-Ireland	WesternEuropean
French	WesternEuropean
Mediterranean	SouthernEuropean
Central_SouthAmerican	LatinAmerican
Cajun_Creole	NorthAmerican
Belgium	WesternEuropean
China	EastAsian
korean	EastAsian
Germany	WesternEuropean
South-America	LatinAmerican
Spain	SouthernEuropean
Netherlands	WesternEuropean
Scandinavia	NorthernEuropean
Philippines	SoutheastAsian
Indonesia	SoutheastAsian
East-African	African
Scandinavian	NorthernEuropean
Greek	SouthernEuropean
American	NorthAmerican
Vietnam	SoutheastAsian
western	WesternEuropean
African	African
Switzerland	WesternEuropean
West-African	African
France	WesternEuropean
Thai	SoutheastAsian
Thailand	SoutheastAsian
Italian	SouthernEuropean
Pakistan	SouthAsian
Irish	WesternEuropean
Mexican	LatinAmerican
Portugal	SouthernEuropean
Chinese	EastAsian
Mexico	LatinAmerican
German	WesternEuropean
Spanish_Portuguese	SouthernEuropean
India	SouthAsian
Japanese	EastAsian
Moroccan	African
Southern_SoulFood	NorthAmerican
Malaysia	SoutheastAsian
Austria	WesternEuropean
English_Scottish	WesternEuropean
Asian	
Southwestern	NorthAmerican
Japan	EastAsian
italian	SouthernEuropean
